"filename", "language", "Java", "comment", "blank", "total"
"c:\Users\ignac\Desktop\Main\Comp_Sci\2024-25\COM1003 Java Programming\Java\Jupiter\src\main\java\com\ang\Core\Moves\MoveList.java", "Java", 8, 0, 1, 9
"c:\Users\ignac\Desktop\Main\Comp_Sci\2024-25\COM1003 Java Programming\Java\Jupiter\src\main\java\com\ang\Engine\Evaluation.java", "Java", 0, 0, 11, 11
"c:\Users\ignac\Desktop\Main\Comp_Sci\2024-25\COM1003 Java Programming\Java\Jupiter\src\main\java\com\ang\Engine\Quiescence.java", "Java", -2, 0, 5, 3
"c:\Users\ignac\Desktop\Main\Comp_Sci\2024-25\COM1003 Java Programming\Java\Jupiter\src\main\java\com\ang\Engine\Search.java", "Java", -2, 0, -1, -3
"c:\Users\ignac\Desktop\Main\Comp_Sci\2024-25\COM1003 Java Programming\Java\Jupiter\src\main\java\com\ang\Engine\Search2.java", "Java", 11, -21, -1, -11
"c:\Users\ignac\Desktop\Main\Comp_Sci\2024-25\COM1003 Java Programming\Java\Jupiter\src\main\java\com\ang\Engine\ThreadLauncher.java", "Java", 47, 0, 12, 59
"c:\Users\ignac\Desktop\Main\Comp_Sci\2024-25\COM1003 Java Programming\Java\Jupiter\src\main\java\com\ang\Engine\Transposition\TranspositionTable.java", "Java", 4, 0, 0, 4
"c:\Users\ignac\Desktop\Main\Comp_Sci\2024-25\COM1003 Java Programming\Java\Jupiter\src\main\java\com\ang\Engine\Worker.java", "Java", 4, 0, 0, 4
"c:\Users\ignac\Desktop\Main\Comp_Sci\2024-25\COM1003 Java Programming\Java\Jupiter\src\main\java\com\ang\Game.java", "Java", 0, 0, 1, 1
"Total", "-", 70, -21, 28, 77